XXXXXXXXXXXXXXXXXXXX
X................Y.X
X..BBP.............X
X.................BX
X.......X..........X
X...XX...X.........X
X..................X
X........XXX....G..X
X........XHX.......X
X........X.X.......X
X.G................X
X..................X
XBPBBBBBBBBPBBBPBBBX
X.........Y........X
XXXXXXXXXXXXXXXXXXXX