XXXXXXXXXXXXXXXXXXXX
XG...XXXXXXXXXX...YX
X.....XXXXXXXX.....X
X......XXXXXX......X
X.......XXXX....B..X
X........XX....BTB.X
XB..............B.PX
XPB.......H......BBX
XB................PX
X........XX........X
X.......XXXX.......X
X......XXXXXX......X
X.....XXXXXXXX.....X
X....XXXXXXXXXX...GX
XXXXXXXXXXXXXXXXXXXX