XXXXXXXXXXXXXXXXXXXX
X........H.......G.X
X..XXX.............X
X.................BX
X.......XP.........X
X...XX..BX.........X
X..................X
X........GPG.......X
X...X....XXX.......X
X........X.X.......X
X..........X.......X
X..................X
XXXXXX.......BPBPBBX
XY................YX
XXXXXXXXXXXXXXXXXXXX