XXXXXXXXXXXXXXXXXXXX
X.Y....XBBX.XBBBXX.X
X..Y.........B.X...X
X......XXX...XBX...X
X......B.B.G.......X
X.G....XXX...XBX...X
X............X.....X
X......BBB.X.XBX...X
X.H...........Y....X
X......X.X...BBBXX.X
X.......X......X.X.X
X...............G..X
X..BB........XXX...X
X............X.X...X
XXXXXXXXXXXXXXXXXXXX